- Jingoism :: Needless motivation for one's country or organization, as a result of bombastic self-pride. Santhosh is a jingoistic man that believes that he's going to hit diamond in a week.
- Despondency :: A state of series of misfortune that heavily impact's one circumstance. Sometimes, we become despondent after looking at placements, just to turn around and queue up for another valo comp.
- Exhilaration :: An exciting and joyful moment that usually sprout a great deal of fun. Speaking with strangers is exhilarating sometimes since you realise that this is the person you've always been looking for, like look at those fresh organs.
- Caricature :: It is a way of describing something in a exaggerated manner often in a ludicrous way. Detective, this is disturbing, the suspect drew a caricature with the blood of the victim, how demonic.
- Roseate :: The state of being extremely optimistic; fully buoyant. Listen, it doesn't hurt to think a little negatively from time to time, being all roseate and believing in god while a person is being stabbed to death isn't a very great idea in my opinion.
- Hubris :: Needless pride or conceit for self-damnation. In the olden days, kings wished to die in hubris in a way against their kingdom, however most died sitting in their own throne poisoned by the minister, this case doesn't seem like a replica of the sort.
- Premonition :: Intense forewarning. I did have a premonition about the murder taking place on the 61st street but I would've never guessed that it was actually going to happen.
- Petulant :: Stubborn on silly matters. Some of the people I know are extremely petulant and never back down in an argument, I have little praise for their method of debate though.
- Recondite :: Obscure or hidden. This murder does have quite a few recondite elements, how did the murderer even get into the house at all?
- Sedulous :: Meticulous and painstaking. The owner was one that was sedulous in her work, keeping track of accounts and business deals in well planned out ledgers.
- Diffidence :: Losing an opportunity because they don't have confidence in their ability. Why did the murderer not take down anyone else in the family? Was he just diffident on getting the entire job done? I suppose not.
- Exacerbate :: When a condition is further worsened by negligible governance. The escape route was very well planned out too, the owners really did exacerbate their situation by not cleaning up the backyard.
- Stolid :: Less emotional than others. Did you hear what the detective said? It really does seem like he's a stolid man considering that he didn't rise to the bait of the murderer and took a squad with him.
- Innocuous :: Harmless and naturally good for health. Detective, did you really believe that I'd be an innocuous man? Of course I wouldn't be surrendering myself to you, that makes no sense!
- Inchoate :: A state of partial development which is insufficient. The preparation for my future is inchoate, and practically useless, there's not much else to say.
- Capricious :: Sudden, impulsive and behaving in a crazy way. The actions that man took for his family's safety was capricious, but luckily no one was harmed.
- Lionize :: To treat someone like a celebrity. One really wonders whether influencers need to be lionized all that much considering the sub standard effort they put into their content.
- Gainsay :: Deny or contradict. No, I will not gainsay any of these people, their worries are valid and need to be heard!
- Conspicuous :: Noticeable. The changes that the company is making towards their increasing demand is conspicuous to say the least.
- Ephemeral :: Something that stays for a short duration. Don't worry about it, being shamed in class is definitely going to be an ephemeral experience for our child, he's definitely not going to be traumatized.
- Ramification :: The consequences. Are you for real? Why did you whip out your cock in the middle of the show, the ramifications for this are going to be intense.
- Jeremiad :: A prolonged resentment over a thing usually seen as a complaint. Are you still passing jeremiads on the ice cream truck guy? He only molested you once!
- Decadent :: Having no control over indulgence. Listen, I'm not decadent, I'm just really close to Diamond 1 in the game, queue up again, Jim!
- Incendiary :: Tending to cause fire, or very intense. The conversation became an incendiary debate on who deserves the prize.
- Countermand :: To recall an order, or revoke a license. Wait, you're actually going to countermand me because I shot that black man? That's absurd!
- Inexorable :: Impossible to prevent something; inevitable. Yup, they can't stop me, me breaking out of jail is inexorable.
- Penury :: Destitution, and homelessness. Despite breaking out of jail, Harlot spent a good year in penury before he got rid of his diffidence and picked up a store job.
- Volubility :: The quality of talking fluently. Volubility is well received in today's world, stammering and overspeaking is viewed in disgrace though.
- Entrenched :: Anything is firmly estalished, unlikely to change. Huh, I always figured that the government would be entrenched and nothing would change, perhaps now's the time for change.
- Hoary :: Process of aging and becoming greyish white. That hoary man wished to prey on little children, good that the volubile judge didn't let him go that easily.
- Craven :: Lacking courage. The craven student was diffident about his inchoate progress to give a speech on it.
- Intrepid :: Being courageous. The ones that become generals in the army are intrepid ones, ones that can face a gun to their temple and not bat an eye.
- Lugubrious :: Sad, and mournful. Listening to Joji is a lugubrious experience but I don't think I'd trade it for anything else.
- Vivacious :: Characterized by joy. The officer was vivacious for some odd reason, his task was only paperwork.
- Extirpation :: Act of destroying at the root. Some believe that killing baby hilter would have extirpated the world war.
- Foible :: Having a minor weakness in one's character. If there's something that makes Arthur foible, it would have to be his family.
- Protean :: Sudden changes. Due to covid, the economy was protean as all hell, no one knew what was to happen.
- Slatternly :: Being untidy or unkempt. I lead life in a slattern fashion.
- Nonplussed :: Confused. After listening to a talk about alcohol, Fathima was nonplussed about a lot of things, starting with, how did she even end up here?
- Diabolical :: Devil-like. The shots that some pros hit are diabolical, that aim is insane!
- Trite :: Being commonplace; having no original value. A lot of the people that feel like they're a part of the cool kids club are generally as trite as one can get, with nothing defining them as one of a kind.
- Compunction :: Uneasiness caused by guilt or remorse. Sometimes these people also writhe in compunction since they lie to those around them about how exciting their day has been.
- Despotic :: A leader or government with illimitable power they can exercise to any extent. While these trite humans believe that they are despotic, it is ironical that they hold little power in influencing those around them significantly.
- Abstemious :: Saying no to food or alcohol; restraining indulgence. While most ordinary humans would have some form of restraint, these abstemious reprobates care too little about their cash and give in to their desires without hesitation.
- Tumultuous :: Disordered and widely agitating. A tumultuous group generally brings school bullies down to their knees.
- Listless :: Lacking interest or feeling tired. A lot of spendthrifts turn listless when they look at their bank statement, I wonder if they've ever considered a parsimonous lifestyle.
- Debauchery :: Extreme indulgence in bodily pleasures. While the bible talks about the evils of Rome against their god, the debauchery of priests who molest children is overlooked.
- Platitude :: Quality of being flat, dull, monotonous and boring. Priests are generally platitude until you start talking about children.
- Harbringer :: Forerunner; one that initiates a major change. I'm waiting for the harbringer of child protective services, these priests are starting to get out of hand.
- Hiatus :: A temporary break or interval. The last I remember, Haikyuu went on hiatus and returned back six years later with garbage animation quality.
- Impetuous :: Something is done without a forethought; haste; rash. That impetuous priest let the child go without telling him to stay silent and now our church is under fire!
- Ebullience :: Showing lively or enthusiastic expression of thoughts. Why does that priest look ebullient all of sudden? Wait, why is that child crying?
- Highfalutin :: Being very pretentious and fanciful. The highfalutin girls at college wear exotic dresses, that would be cool normally but most of them look like whores.
- Beautitude :: The state of supreme happiness. The priest said that he was expressing his beautitude to the child in that room, somehow that seems fishy.
- Beholden :: Indebted and thankful. A new gaming laptop generally has me beholden to my parents, there's not much else I desire in life.
- Clandestine :: Acting in secrecy, duplicity. One fine clandestine evening, Shishimaru snuck cocaine into Ninja Hattori's food.
- Vicarious :: Experienced or realized through sympathetic participation. Some people say that watching others skydive is a vicarious thrill when you're afraid of heights, but I could say the same for netorare.
- Indelible :: Incapable of being erased. Vietnamese veterans generally have an indelible experience of the war, for example, a disco light caused my grandfather to have a stroke.
- Fortitude :: Strength of mind. Mental fortitude is hard to come by in people with a pornographic addiction.
- Medley ::  A diverse assortment or mixture. The businessman showed Ashley a medley of pleasure instruments.
- Halcyon :: Marked with tranquility, contentment and happiness. Japanese backyards present you with a halcyon setting for relaxation.
- Perjury :: Act of going against one's oath. Perjury is trite in No Nut November challenges, most people don't have the fortitude for it.
- Desuetude :: State of disuse and being rundown. Once a fire broke out and killed 20 people in the building, no one has rented out a flat in the building, look at the desuetude.
- Forbearance :: State of tolerant and being self-restrained. No nut november is all about forbearance and fortitude.
- Treacherous :: Betrayal or deceptive. Being a treacherous man in the army sounds like a good way to die on the battlefield.
- Fractious :: Being very stubborn. I know far too many people that are fractious, it's a breath of fresh air to meet someone that doesn't take offense to my words.
- Peerless :: Having no match to another; distinct. The Wandering Inn is a peerless novel, yet it is a pity that it is not well known.
- Objurgate :: To express a strong disapproval of something. Listen officer, I objurgate child trafficking too, why are you arresting me?
- Recrudesce :: To happen again or breat out. Even after the murderer is caught, people are afraid of it recrudescing.
- Philistine :: Having a cruel disregard or dismay to arts or artistic things. Showing that philistine man your artwork was the one way to ruin your cherubic day and you managed to do it.
- Frailty :: A fault due to weakness of moral character. Netorare is a genre that is filled with the frailty of the spouse.
- Brusque :: Blunt in manner or speech; being abrupt or rude. Most call me a brusque man, but I really just don't like beating around the bush.
- Intractable :: Uncontrollable. Once you piss off an intractable man, it's hard to stop his harangue.
- Tenacious :: Holding tight. A tenacious mind allows one to solve even the most ridiculous of puzzles.
- Succinct :: Clear and sensible. The ones who shine during a debate are those that are succinct in their responses.
- Perfunctory :: Lacking interest. Greeting guests in a perfunctory task, and if I could, I'd do away with it in a heartbeat.
- Inveterate :: Firmly established or rooted; habitual. Browsing through instagram is an inveterate habit that I would like to get rid of.
- Recourse :: A source of help in a difficult situation. After ordering far too much for the dine-in, Jack's only recourse to not waste food was to pack it up for a takeaway.
- Perfidious :: The act of betraying someone or something. Once I dashed into site, the team's perfidy deeply wounded me as they did not rush into site. Unsurprisingly, we ended on a 11-13 loss.
- Atrophy :: A wasting away or progressive decline; reduction in quality. The tempetuous winds caused the freshly painted houses to fall into atrophy.
- Ostensible :: Intended for display; open for view. Window shopping isn't allowed? I thought it was an ostensible shop.
- Unearth :: Discover and bring to light. Once the catacombs had fallen, the mysterious of the city's haunted sewer system were unearthed.
- Irrevocable :: Final and unalterable. The judge has made their irrevocable decision, there is no use pleading now.
- Contrite :: Feeling or showing sorrow and remorse for a sin. Most people who confess in church are contrite with the sins they have committed.
- Ineptitude :: The quality of being incompetent. That guy was as inept as one can get with his mediocre magic tricks.
- Pertain :: Belong as a part. This passage pertains to the Book of the Kamasutra!
- Expiation :: The act or process of atonement. One goes from being contrite to expiating for the sins they have committed.
- Rebuff :: Snub. He rebuffed me despite providing perfectly reasonable logic.
- Fidelity :: Loyalty; accuracy. Despite expressing my fidelity, the group's perfidy took me to tears.
- Stigma :: Mark of shame; disgrace. There is a stigma attached to White Gnolls from the Wandering Inn.
- Extinguish :: End something. The reign of Alexander the Great was extinguished by Malaria or Typhoid.
- Bolster :: Support or reinforce. One expects camaraderie from their friends and a bolster to live a good life, why did I end up with valorant and rank pushing?
- Taut :: Tightly stretched. The line for tight rope walking is always taut, it'd be a disaster otherwise.
- Loll :: Rest or laze around. The mayor lolled on his extravagant sofa all day today.
- Diaphanous :: Transparent; gauzy. The window was oddly dusty, you'd expect one here to be diaphanous and near invisible.
- Abstruse :: Obscure. I successfully managed to abstruse my escape route to get rid of the officers, let's go snort some coke.
- Predilection :: An established preference for something. Most people have a predilection towards chocolate when you compare it with pista.
- Writ :: Written order. This writ right here orders you to court, young man, don't you walk away from me!
- Jabber :: Talk excitedly. You could call it loquacious or jabbering, but all I find it is plain annoying.
- Scabbard :: Sheath for a blade. I can see a scabbard here but no blade in it, that's weird.
- Vigilant :: Noticing the happenings of the surroundings. He's a vigilant officer and managed to stop two sexual assaults from taking place.
- Indigence :: Poverty. I've lived in indigence before and that's why I don't want my children to go through this ordeal at all.
- Commuter :: A person who travels regularly. One expects commuters to commute to office regularly but post covid? No one wants to even go to the office anymore.
- Fluster :: Make nervous or confused. Okari-chan became flustered when she babbled unintelligible speech in nervousness.
- Propinquity :: Nearness of blood; kinship. The propinquity that one speaks of in stories is seldom visible in real life.
- Frantic :: Widely excited with joy. He made frantic arrangements when he realized that his friends were going to be coming over.
- Eulogy :: Formal; parise; panegyric. The minister delivered a eulogy for Mukesh, how admirable.
- Coerce :: Compel to make obedient. Some people are really good at coercing you into investing into their product.
- Recluse :: One who avoids people. Max is a genius, but he is reclusive and as such you don't see him all that much.
- lethargic :: lacking energy. It's common to be lethargic the second day after going to the gym, but trust me, the third day is worse.
- obdurate :: stubbornly refusing to change one's opinion. Sometimes, I really wonder whether I'm wasting my time arguing about the better sex with some obdurate fools.
- philanthropic :: seeking to promote the welfare of others. A lot of millionaires are philanthropic, they say it's because they care about the world, but I'm pretty sure it's just to cover up the fact that they don't know what to do with it.
- waver :: to go back and forth between choices. Voting is something that I don't think I'll ever waver on, the votes are manipulated anyway, so it doesn't really matter.
- bolster :: to support or strengthen. Boaster's IGL skills bolsters the teamplay, but what can one really do against the demon that is TenZ.
- dissonance :: a lack of harmony or agreement. It's fun to take part in hackathons until the team faces the issue of dissonance, arguments pick up and everything falls apart quickly.
- garrulous :: excessively talkative. Gary is a garrulous man, one could also call him loquacious too.
- malleable :: easily influenced; pliable. I said the child was malleable, that meant that you could mold him to be better, not hit him with a hammer!
- ostentation :: excessive display of wealth. You'd notice that the rich folk are always up for ostentation but the extremely rich folk don't display their wealth at all.
- prevaricate :: avoid telling the truth by not directly answering a question. I know a lot of people that prevaricate because they're scared of what might be if people know what they're upto.
- yoke :: bond; tie; subjection. The yoke of religion unites quite a few, but somehow it just seems like the formation of a cult to me.
- xenophobia :: Intense or irrational dislike of people from other countries. I doubt that people with xenophobia are well-liked in the public view nowadays, racial supremacy is a dead concept, and the ones who follow it now are idiots.
- winnow :: sift out, filter out. Some universites tend to winnow their applications based on grade, gender, and the place they hail from.
- welter :: confusion, jumble, tangle. That entire discussion was welter, it went completely over my head.
- vociferous :: blatant, clamorous, noisy. I think I have a headache from those vociferous arguments coming from next door, I hope the couple just get a divorce and move on.
- vitriol :: cruel and bitter criticism. Some people are so filled with vitriol that they vitiate those around them too.
- vitiate :: destroy or impair. One tends to be a lot more sadistic once they are faced with scenarios that vitiate their mindset.
- virulent :: toxic, deadly, destructive. Imagine having another pandemic, the entire stock market is going to plummet and shopkeepers would become virulent with frustation.
- umbrage :: offense or annoyance. I am so filled with anger after the umbrage that John hit me with.
- tyro :: a beginner or novice. Everyone is a tyro at some point, even the greatest have had to have simple beginnings.
- toady :: be servile towards, grovel to. I hate Smith, he's always ready to toady up to the boss.
- Inculcate :: Instill an attitude, idea or habit. Inculcating the habit of exercise in a schedule is a good practice.
- Indolence :: Avoidance of activity or exertion. That indolent fat man ruined my appetite with his gross method of consumption.
- Irascible :: Having or showing a tendency to be easily angered. Sometimes, it's better to shut your mouth after someone's had a bad day, they're definitely irascible and prone to taking it out on you.
- Hapless :: Unfortunate. Sometimes I really wonder if I'm hapless or just a fool.
- Grouse :: Complain pettily. Stop grousing for no reason, just give me a bit and we'll be off.
- anachronism :: Something old-fashioned. I have a friend who method of thinking is anachronistic
- ameliorate :: to improve or mitigate a situation. Attempt o ameliorate all you wil, but the teacher is not going to award you any more marks.
- contentious :: Involding conflict. William has a contentious mouth that is sure to get him into trouble at some point.
- cosmopolitan :: Sophisticated. Maganizes and articles contain cosmopolitan trends of the today.
- Craven :: Cowardly to the point of being shameful. He lived a craven life, seeking help from others and serving as their simp while they beg for help.
